11111111
1C001E01
1C000001
1P000C01
11111111