11111111
100P0001
1C000001
10000E01
11111111