111111111111111
100000000000001
100010000000001
100010000000001
1000100C0000001
100010000000001
100010000000001
100010000000001
100010000000001
1P0E10000000001
111111111111111